S+OE+SSSSE
EEOE+O+OOE
SO+SOOEBSE
ES+SESEEOO
SOEO+E+SOE
AES+EOOSOE
E+E+OO+OSS
SESSSEOOS+
+OOOE+O+OS
S+OE++OESO
